S........T
#T##..#S#.
#.###E###E
#.E.S.###.
###T#####G
