...#.....T
#T.#..###.
#.###.###.
#S....E##S
###T#####G

