...#.....T
#T.#..###.
#.###.###E
#S.G#.E##S
###T#####G

