...#.....T
#T.#..###.
#.###.###E
#S..#.E##S
###T#####G

