...#.....T
#T.#..###.
#.###.###E
#S#E..E##S
###T#####G

