S###ST..
#.#...#E
##....#G
##.#ST..
#.#...#E
#T#...EG
